R 2560 1440
NO textures/wall/jail.xpm
SO textures/wall/stone.xpm
WE textures/wall/wood.xpm
EA textures/wall/mossy.xpm
S textures/sprite/mickey.xpm
F 141,101,0
C 237,254,255

111111111111111111111
100000000111000000001
100000000111000000001
100000000000000000001
100000200011000200001
100000000011000000001
100000000011000000001
100000000000000000001
100000000002000000001
111111100000000111111
111111100000000011111
100000000000000000001
10000000000N000000001
100000000000000000001
111111111111111111111
