R 1000 1000
NO textures/wall/jail.xpm
SO textures/wall/stone.xpm
WE textures/wall/wood.xpm
EA textures/wall/mossy.xpm
S textures/sprite/mickey.xpm
F 141,101,0
C 237,254,255

111111111111111111111
100000000111000000001
100000000111000000001
100000000000000000001
100002000000000020001
100000000000000000001
100000000    00000001
100000000    00000001
100000000000000000001
111111000000000001111
111111000000000001111
100000000000000000001
10000000000N000000001
100011000000000000001
111111111111111111111
