R 2560 1440
NO ../textures/wood.xpm
SO ../textures/stone.xpm
WE ../textures/sand.xpm
EA ../textures/mossy.xpm
S ../textures/mickey.xpm
F ../textures/mossy.xpm
C ../textures/mossy.xpm

111111111111111111111
100000000111000000001
100000000111000000001
100000000000000000001
100000000000000000001
100000000000000000001
100000000011000000001
100000000011000000001
100000000000000000001
111111000000000001111
111111000000000001111
100000000000000000001
10000000000N000000001
100011000000000000001
111111111111111111111
